11111111111111111111111111
1C000010000000000000000001
100P0010C00000000000000001
10000011111110011100100001
11110000000000000000100001
1C000000001000C00100100001
1000000000000000000010C001
10000011111001111111111111
100000000C100000000000E0C1
1000000000100000C000000001
11111111111111111111111111