11111111111
10000000001
10000C00P01
 0000000001
10000000E01
11111111111